28 28 28 28 28 28 28 28 28 28 28 28 28 28 28 28 28 28 28 28 28 28 28 28 28 28 28 28 28 28 28 28 28 28 28 28 28 28 28
28 28 28 28 28 28 28 28 28 28 28 28 28 28 28 28 28 28 28 28 28 28 28 28 28 28 28 28 28 28 28 28 28 28 28 28 28 28 28
28 28 28 28 28 28 28 28 28 28 28 28 28 28 28 28 28 28 28 28 28 28 28 28 28 28 28 28 28 28 28 28 28 28 28 28 28 28 28
28 28 28 28 28 28 28 28 28 28 28 28 28 28 28 28 28 28 28 28 28 28 28 28 28 28 28 28 28 28 28 28 28 28 28 28 28 28 28
28 28 28 28 28 28 28 28 28 28 28 28 28 28 28 28 28 28 28 28 28 28 28 28 28 28 9 28 28 28 28 28 28 28 28 28 28 28 28
28 28 28 28 28 2 0 0 0 11 28 28 28 28 28 2 0 0 0 0 0 0 0 0 0 0 4 0 0 0 0 0 0 11 30 30 30 30 30
28 28 28 28 28 6 28 28 28 6 27 27 27 27 27 6 32 32 32 32 32 32 32 32 32 32 6 30 30 30 30 30 30 6 30 30 30 30 30
28 28 28 28 28 6 28 28 28 6 27 27 27 27 27 6 32 27 27 27 27 27 27 27 27 27 6 30 30 30 30 30 30 6 30 30 30 30 30
28 28 28 28 28 6 28 28 28 6 27 27 9 27 27 6 32 27 32 32 32 29 29 29 29 29 6 30 30 30 30 30 30 6 30 30 30 30 30
28 28 28 28 28 6 28 28 28 1 0 0 4 0 0 12 32 32 32 27 27 27 29 29 29 29 6 30 30 30 30 30 30 6 30 30 30 30 30
28 28 28 28 28 6 27 27 27 27 27 27 6 27 27 27 27 27 27 2 0 0 11 31 31 31 6 30 30 30 30 30 30 6 30 30 30 30 30
28 28 28 28 28 6 27 27 27 27 27 27 6 27 27 27 27 30 30 6 30 30 6 31 31 31 6 30 30 30 30 30 30 6 30 30 30 30 30
28 28 28 28 28 4 0 0 0 0 0 0 4 0 0 0 0 0 0 4 0 0 4 0 0 0 4 30 30 30 30 30 30 6 30 30 30 30 30
28 28 28 28 28 6 28 28 28 28 28 28 6 28 28 28 28 28 28 6 28 2 12 28 28 28 6 30 30 30 30 30 30 6 30 30 30 30 30
28 28 28 28 28 6 28 28 28 28 28 28 6 27 27 27 2 0 0 12 27 6 27 27 27 27 6 30 30 30 30 30 30 6 30 30 30 30 30
28 28 28 28 28 6 28 28 28 28 28 28 6 27 27 27 6 27 27 27 27 6 27 27 27 27 6 30 30 30 30 30 30 6 30 30 30 30 30 30
28 28 28 28 28 6 28 28 28 28 28 28 6 27 27 27 6 27 27 27 27 6 27 27 27 27 6 30 30 30 30 30 30 6 30 30 30 30 30 30
28 28 28 28 28 6 28 28 28 28 28 28 4 0 0 0 4 0 0 0 0 4 0 0 0 0 4 30 30 30 30 30 30 6 30 30 30 30 30 30
28 28 28 28 28 6 28 28 28 28 28 28 6 28 28 28 28 28 28 28 28 28 28 28 28 28 6 30 30 30 30 30 30 6 30 30 30 30 30 30
28 28 28 28 28 6 28 28 28 28 28 28 6 28 28 28 28 28 28 28 28 28 28 28 28 28 6 30 30 30 30 30 30 6 30 30 30 30 30 30
28 28 28 28 28 6 28 28 28 28 28 28 6 28 28 28 28 28 28 28 28 28 28 28 28 28 6 30 30 30 30 30 30 6 30 30 30 30 30 30
28 28 28 28 28 6 28 28 28 28 28 28 6 28 28 28 28 28 28 28 28 28 28 28 28 28 6 30 30 2 0 0 0 4 3 30 30 30 30 30
28 28 28 28 28 6 28 28 28 28 28 28 6 28 28 28 28 28 28 28 28 28 28 28 28 28 6 30 30 6 28 28 28 6 28 28 28 28 28
28 28 28 28 28 6 28 28 28 28 28 28 6 28 28 28 28 28 28 28 28 28 28 28 28 28 6 30 30 6 28 28 28 6 28 28 28 28 28
28 28 28 28 28 6 28 28 28 28 28 28 6 28 28 28 28 28 28 28 28 28 28 28 28 28 6 30 30 6 28 28 28 6 28 28 28 28 28
28 28 28 28 28 6 28 28 28 28 28 28 6 28 28 28 28 28 28 28 28 28 28 28 28 28 4 0 0 12 28 28 28 6 28 28 28 28 28
28 28 28 28 28 6 28 28 28 28 28 28 6 28 28 28 28 28 28 28 28 28 28 28 28 28 6 28 28 28 28 28 28 6 28 28 28 28 28
28 28 28 28 28 6 28 28 28 28 28 28 6 28 28 28 28 28 28 28 28 28 28 28 28 28 6 28 28 28 28 28 28 6 28 28 28 28 28
28 28 28 28 28 6 28 28 28 28 28 28 6 28 28 28 28 28 28 28 28 28 28 28 28 28 6 28 28 28 28 28 28 6 28 28 28 28 28
28 28 28 28 28 6 28 28 28 28 28 28 6 28 28 28 28 28 28 28 28 28 28 28 28 28 6 28 28 28 28 28 28 6 28 28 28 28 28
28 28 28 28 28 6 28 28 28 28 28 28 6 28 28 28 28 28 28 28 28 28 28 28 28 28 6 28 28 28 28 28 28 6 28 28 28 28 28
28 28 28 28 28 6 28 28 28 28 28 28 6 28 28 28 28 28 28 28 28 28 28 28 28 28 6 28 28 28 28 28 28 6 28 28 28 28 28
28 28 28 28 28 6 28 28 28 28 28 28 6 28 28 28 28 28 28 28 28 28 28 28 28 28 6 28 28 28 28 28 28 6 28 28 28 28 28
28 28 28 28 28 6 28 28 28 28 28 28 6 28 28 28 28 28 28 28 28 28 28 28 28 28 6 28 28 28 28 28 28 6 28 28 28 28 28
28 28 28 28 28 1 0 0 0 0 0 0 4 0 0 0 0 0 0 0 0 0 0 0 0 0 4 0 0 0 0 0 0 12 28 28 28 28 28
28 28 28 28 28 28 28 28 28 28 28 28 8 28 28 28 28 28 28 28 28 28 28 28 28 28 8 28 28 28 28 28 28 28 28 28 28 28 28
28 28 28 28 28 28 28 28 28 28 28 28 28 28 28 28 28 28 28 28 28 28 28 28 28 28 28 28 28 28 28 28 28 28 28 28 28 28 28
28 28 28 28 28 28 28 28 28 28 28 28 28 28 28 28 28 28 28 28 28 28 28 28 28 28 28 28 28 28 28 28 28 28 28 28 28 28 28
28 28 28 28 28 28 28 28 28 28 28 28 28 28 28 28 28 28 28 28 28 28 28 28 28 28 28 28 28 28 28 28 28 28 28 28 28 28 28
28 28 28 28 28 28 28 28 28 28 28 28 28 28 28 28 28 28 28 28 28 28 28 28 28 28 28 28 28 28 28 28 28 28 28 28 28 28 28