01110000000001111100000000000000000
01111110000000011000011111111111111
01111111000002222200000000001111111
01222000000000000000000000000001111
01111111111000022222000000000000000
01110000000000000000000000011111000
01110000222222000000000000000000000
01110000000000011111111110000000000
01110000000000000000000000000000000
01110000011111111100000000000000000
01110000000000000000000000000000000
00000000002222222000000000000000000
00000000222222222200000000000000000
00000000000000000000000000000000000
00000000001111111100000000000000000
00000000000000000000000000000000000
00000000011111111111111110000000000
00000000000000000000000000000000000
00000000000000000000000000000000000
00000000000000000000000000000000000
00000000000000000000000000000000000
00000000000000000000000000000000000
00000000000000000000000000000000000
00000000000000000000000000000000000
00000000000000000000000000000000000
00000000000000000000000000000000000
00000000000000000000000000000000000
00000000000000000000000000000000000
00000000000000000000000000000000000
00000000000000000000000000000000000
00000000000000000000000000000000000
00000000000000000000000000000000000
00000000000000000000000000000000000
00000000000000000000000000000000000
00000000000000000000000000000000000